NO ./textures/no/North_texture.xpm
WE ./textures/we/West_texture.xpm
SO ./textures/so/South_texture.xpm
EA ./textures/ea/EA.xpm

F 220,100,0
C 100,30,50

111111
1000001
1010001
10010011111111111
10000000000000001111
10000E00000001000001
11111111111101111111
    111111111111 111
1111111111111111 111