NO ./textures/no/North_texture.xpm
WE ./textures/we/West_texture.xpm
SO ./textures/so/South_texture.xpm
EA ./textures/ea/East_texture.xpm

F 220,100,0
C 225,30,0

111111
1000001
1010101
10010011111111111
10000000000000001111
10000W00000000000001
11111111111111111111