WE ./textures/we/West.xpm
SO ./textures/so/South.xpm
EA ./textures/ea/East.xpm
NO ./textures/no/North.xpm

F 50,50,50
C 50,30,50

111111
1000001
1010001
10010011111111111
10000000000000001111
10000E00000010000001
11111111111101111111
    111111111111 111
1111111111111111 111