NO ./path_to_the_north_texture
WE ./path_to_the_west_texture
SO ./path_to_the_south_texture
EA ./path_to_the_east_texture

F 220,100,0
C 225,30,0

1111111
1000001
1010101
100100111111
10000W000001
111111111111